NO ./textures/42_map/pink_wall.png
SO ./textures/42_map/purple_wall.png
WE ./textures/42_map/green_wall.png
EA ./textures/42_map/blue_wall.png

F 255,223,186

C 186,225,255

11111111111111111111111111111
10000000001100000000000000001
10110000011100000000000010001
10010000000000000000000010001
10110000011100000000000010001
10000000001100000111011110001
11110111111111011100000010001
11110111111111011101010010001
11000000110101011100000010001
10000000000000001100000010001
10000000000000001101010010001
11000000110101000000000000001
11110111110101000000101000001
10000000001100000100000010001
10000000000000001000100001001
10000000001000010000000001001
10000000001101000000N00000001
10000000000100000001010000001
11111111111111111111111111111
